/**********************************************
 *	Copyright(C)SEGA 1996/SYSTEM R&D DEPT
 *	foreground.map
 *	MAP SIZE   = 1 x 1
 *	PLANE SIZE = PL_SIZE_1x1
 *	PAGE TYPE  = PNB_1WORD|CN_12BIT
 *	COLOR TYPE = COL_TYPE_256
 *	CHAR. SIZE = CHAR_SIZE_2x2
 **********************************************/
Uint16	map_foreground[] = {
	0x0000,0x0002,0x0004,0x0006,0x0000,0x0002,0x0004,0x0006,
	0x0000,0x0002,0x0004,0x0006,0x0000,0x0002,0x0004,0x0006,
	0x0008,0x0000,0x0002,0x0004,0x0006,0x0008,0x0000,0x0000,
	0x0000,0x0000,0x0000,0x0000,0x0000,0x0000,0x0000,0x0000,
	0x0040,0x0042,0x0044,0x0046,0x0040,0x0042,0x0044,0x0046,
	0x0040,0x0042,0x0044,0x0046,0x0040,0x0042,0x0044,0x0046,
	0x0048,0x0040,0x0042,0x0044,0x0046,0x0048,0x0000,0x0000,
	0x0000,0x0000,0x0000,0x0000,0x0000,0x0000,0x0000,0x0000,
	0x0080,0x0082,0x0084,0x0086,0x0080,0x0082,0x0084,0x0086,
	0x0080,0x0082,0x0084,0x0086,0x0080,0x0082,0x0084,0x0086,
	0x0088,0x0080,0x0082,0x0084,0x0086,0x0088,0x0000,0x0000,
	0x0000,0x0000,0x0000,0x0000,0x0000,0x0000,0x0000,0x0000,
	0x00c0,0x00c2,0x00c4,0x00c6,0x00c0,0x00c2,0x00c4,0x00c6,
	0x00c0,0x00c2,0x00c4,0x00c6,0x00c0,0x00c2,0x00c4,0x00c6,
	0x00c8,0x00c0,0x00c2,0x00c4,0x00c6,0x00c8,0x0000,0x0000,
	0x0000,0x0000,0x0000,0x0000,0x0000,0x0000,0x0000,0x0000,
	0x0100,0x0102,0x0104,0x0106,0x0100,0x0102,0x0104,0x0106,
	0x0100,0x0102,0x0104,0x0106,0x0100,0x0102,0x0104,0x0106,
	0x0108,0x0100,0x0102,0x0104,0x0106,0x0108,0x0000,0x0000,
	0x0000,0x0000,0x0000,0x0000,0x0000,0x0000,0x0000,0x0000,
	0x0140,0x0142,0x0144,0x0146,0x0140,0x0142,0x0144,0x0146,
	0x0140,0x0142,0x0144,0x0146,0x0140,0x0142,0x0144,0x0146,
	0x0148,0x0140,0x0142,0x0144,0x0146,0x0148,0x0000,0x0000,
	0x0000,0x0000,0x0000,0x0000,0x0000,0x0000,0x0000,0x0000,
	0x0180,0x0182,0x0184,0x0186,0x0180,0x0182,0x0184,0x0186,
	0x0180,0x0182,0x0184,0x0186,0x0180,0x0182,0x0184,0x0186,
	0x0188,0x0180,0x0182,0x0184,0x0186,0x0188,0x0000,0x0000,
	0x0000,0x0000,0x0000,0x0000,0x0000,0x0000,0x0000,0x0000,
	
	0x0000,0x0002,0x0004,0x0006,0x0000,0x0002,0x0004,0x0006,
	0x0000,0x0002,0x0004,0x0006,0x0000,0x0002,0x0004,0x0006,
	0x0008,0x0000,0x0002,0x0004,0x0006,0x0000,0x0000,0x0000,
	0x0000,0x0000,0x0000,0x0000,0x0000,0x0000,0x0000,0x0000,
	0x0040,0x0042,0x0044,0x0046,0x0040,0x0042,0x0044,0x0046,
	0x0040,0x0042,0x0044,0x0046,0x0040,0x0042,0x0044,0x0046,
	0x0048,0x0040,0x0042,0x0044,0x0046,0x0000,0x0000,0x0000,
	0x0000,0x0000,0x0000,0x0000,0x0000,0x0000,0x0000,0x0000,
	0x0080,0x0082,0x0084,0x0086,0x0080,0x0082,0x0084,0x0086,
	0x0080,0x0082,0x0084,0x0086,0x0080,0x0082,0x0084,0x0086,
	0x0088,0x0080,0x0082,0x0084,0x0086,0x0000,0x0000,0x0000,
	0x0000,0x0000,0x0000,0x0000,0x0000,0x0000,0x0000,0x0000,
	0x00c0,0x00c2,0x00c4,0x00c6,0x00c0,0x00c2,0x00c4,0x00c6,
	0x00c0,0x00c2,0x00c4,0x00c6,0x00c0,0x00c2,0x00c4,0x00c6,
	0x00c8,0x00c0,0x00c2,0x00c4,0x00c6,0x0000,0x0000,0x0000,
	0x0000,0x0000,0x0000,0x0000,0x0000,0x0000,0x0000,0x0000,
	0x0100,0x0102,0x0104,0x0106,0x0100,0x0102,0x0104,0x0106,
	0x0100,0x0102,0x0104,0x0106,0x0100,0x0102,0x0104,0x0106,
	0x0108,0x0100,0x0102,0x0104,0x0106,0x0000,0x0000,0x0000,
	0x0000,0x0000,0x0000,0x0000,0x0000,0x0000,0x0000,0x0000,
	0x0140,0x0142,0x0144,0x0146,0x0140,0x0142,0x0144,0x0146,
	0x0140,0x0142,0x0144,0x0146,0x0140,0x0142,0x0144,0x0146,
	0x0148,0x0140,0x0142,0x0144,0x0146,0x0000,0x0000,0x0000,
	0x0000,0x0000,0x0000,0x0000,0x0000,0x0000,0x0000,0x0000,
	0x0180,0x0182,0x0184,0x0186,0x0180,0x0182,0x0184,0x0186,
	0x0180,0x0182,0x0184,0x0186,0x0180,0x0182,0x0184,0x0186,
	0x0188,0x0180,0x0182,0x0184,0x0186,0x0000,0x0000,0x0000,
};

