/**********************************************
 *	Copyright(C)SEGA 1996/SYSTEM R&D DEPT
 *	level1.map
 *	MAP SIZE   = 1 x 1
 *	PLANE SIZE = PL_SIZE_1x1
 *	PAGE TYPE  = PNB_1WORD|CN_10BIT
 *	COLOR TYPE = COL_TYPE_256
 *	CHAR. SIZE = CHAR_SIZE_2x2
 **********************************************/

Uint16	map_level1[] = {
	0x0000,0x0002,0x0004,0x0006,0x0008,0x000a,0x000c,0x000e,
	0x0010,0x0012,0x0014,0x0016,0x0018,0x001a,0x001c,0x001e,
	0x0020,0x0022,0x0024,0x0026,0x0000,0x0000,0x0000,0x0000,
	0x0000,0x0000,0x0000,0x0000,0x0000,0x0000,0x0000,0x0000,
	0x0040,0x0042,0x0044,0x0046,0x0048,0x004a,0x004c,0x004e,
	0x0050,0x0052,0x0054,0x0056,0x0058,0x005a,0x005c,0x005e,
	0x0060,0x0062,0x0064,0x0066,0x0000,0x0000,0x0000,0x0000,
	0x0000,0x0000,0x0000,0x0000,0x0000,0x0000,0x0000,0x0000,
	0x0080,0x0082,0x0084,0x0086,0x0088,0x008a,0x008c,0x008e,
	0x0090,0x0092,0x0094,0x0096,0x0098,0x009a,0x009c,0x009e,
	0x00a0,0x00a2,0x00a4,0x00a6,0x0000,0x0000,0x0000,0x0000,
	0x0000,0x0000,0x0000,0x0000,0x0000,0x0000,0x0000,0x0000,
	0x00c0,0x00c2,0x00c4,0x00c6,0x00c8,0x00ca,0x00cc,0x00ce,
	0x00d0,0x00d2,0x00d4,0x00d6,0x00d8,0x00da,0x00dc,0x00de,
	0x00e0,0x00e2,0x00e4,0x00e6,0x0000,0x0000,0x0000,0x0000,
	0x0000,0x0000,0x0000,0x0000,0x0000,0x0000,0x0000,0x0000,
	0x0100,0x0102,0x0104,0x0106,0x0108,0x010a,0x010c,0x010e,
	0x0110,0x0112,0x0114,0x0116,0x0118,0x011a,0x011c,0x011e,
	0x0120,0x0122,0x0124,0x0126,0x0000,0x0000,0x0000,0x0000,
	0x0000,0x0000,0x0000,0x0000,0x0000,0x0000,0x0000,0x0000,
	0x0140,0x0142,0x0144,0x0146,0x0148,0x014a,0x014c,0x014e,
	0x0150,0x0152,0x0154,0x0156,0x0158,0x015a,0x015c,0x015e,
	0x0160,0x0162,0x0164,0x0166,0x0000,0x0000,0x0000,0x0000,
	0x0000,0x0000,0x0000,0x0000,0x0000,0x0000,0x0000,0x0000,
	0x0180,0x0182,0x0184,0x0186,0x0188,0x018a,0x018c,0x018e,
	0x0190,0x0192,0x0194,0x0196,0x0198,0x019a,0x019c,0x019e,
	0x01a0,0x01a2,0x01a4,0x01a6,0x0000,0x0000,0x0000,0x0000,
	0x0000,0x0000,0x0000,0x0000,0x0000,0x0000,0x0000,0x0000,
	0x01c0,0x01c2,0x01c4,0x01c6,0x01c8,0x01ca,0x01cc,0x01ce,
	0x01d0,0x01d2,0x01d4,0x01d6,0x01d8,0x01da,0x01dc,0x01de,
	0x01e0,0x01e2,0x01e4,0x01e6,0x0000,0x0000,0x0000,0x0000,
	0x0000,0x0000,0x0000,0x0000,0x0000,0x0000,0x0000,0x0000,
	0x0200,0x0202,0x0204,0x0206,0x0208,0x020a,0x020c,0x020e,
	0x0210,0x0212,0x0214,0x0216,0x0218,0x021a,0x021c,0x021e,
	0x0220,0x0222,0x0224,0x0226,0x0000,0x0000,0x0000,0x0000,
	0x0000,0x0000,0x0000,0x0000,0x0000,0x0000,0x0000,0x0000,
	0x0240,0x0242,0x0244,0x0246,0x0248,0x024a,0x024c,0x024e,
	0x0250,0x0252,0x0254,0x0256,0x0258,0x025a,0x025c,0x025e,
	0x0260,0x0262,0x0264,0x0266,0x0000,0x0000,0x0000,0x0000,
	0x0000,0x0000,0x0000,0x0000,0x0000,0x0000,0x0000,0x0000,
	0x0280,0x0282,0x0284,0x0286,0x0288,0x028a,0x028c,0x028e,
	0x0290,0x0292,0x0294,0x0296,0x0298,0x029a,0x029c,0x029e,
	0x02a0,0x02a2,0x02a4,0x02a6,0x0000,0x0000,0x0000,0x0000,
	0x0000,0x0000,0x0000,0x0000,0x0000,0x0000,0x0000,0x0000,
	0x02c0,0x02c2,0x02c4,0x02c6,0x02c8,0x02ca,0x02cc,0x02ce,
	0x02d0,0x02d2,0x02d4,0x02d6,0x02d8,0x02da,0x02dc,0x02de,
	0x02e0,0x02e2,0x02e4,0x02e6,0x0000,0x0000,0x0000,0x0000,
	0x0000,0x0000,0x0000,0x0000,0x0000,0x0000,0x0000,0x0000,
	0x0300,0x0302,0x0304,0x0306,0x0308,0x030a,0x030c,0x030e,
	0x0310,0x0312,0x0314,0x0316,0x0318,0x031a,0x031c,0x031e,
	0x0320,0x0322,0x0324,0x0326,0x0000,0x0000,0x0000,0x0000,
	0x0000,0x0000,0x0000,0x0000,0x0000,0x0000,0x0000,0x0000,
	0x0340,0x0342,0x0344,0x0346,0x0348,0x034a,0x034c,0x034e,
	0x0350,0x0352,0x0354,0x0356,0x0358,0x035a,0x035c,0x035e,
	0x0360,0x0362,0x0364,0x0366,0x0000,0x0000,0x0000,0x0000,
	0x0000,0x0000,0x0000,0x0000,0x0000,0x0000,0x0000,0x0000,
	0x0380,0x0382,0x0384,0x0386,0x0388,0x038a,0x038c,0x038e,
	0x0390,0x0392,0x0394,0x0396,0x0398,0x039a,0x039c,0x039e,
	0x03a0,0x03a2,0x03a4,0x03a6,0x0000,0x0000,0x0000,0x0000,
	0x0000,0x0000,0x0000,0x0000,0x0000,0x0000,0x0000,0x0000,
	0x0000,0x0000,0x0000,0x0000,0x0000,0x0000,0x0000,0x0000,
	0x0000,0x0000,0x0000,0x0000,0x0000,0x0000,0x0000,0x0000,
	0x0000,0x0000,0x0000,0x0000,0x0000,0x0000,0x0000,0x0000,
	0x0000,0x0000,0x0000,0x0000,0x0000,0x0000,0x0000,0x0000,
	0x0000,0x0000,0x0000,0x0000,0x0000,0x0000,0x0000,0x0000,
	0x0000,0x0000,0x0000,0x0000,0x0000,0x0000,0x0000,0x0000,
	0x0000,0x0000,0x0000,0x0000,0x0000,0x0000,0x0000,0x0000,
	0x0000,0x0000,0x0000,0x0000,0x0000,0x0000,0x0000,0x0000,
	0x0000,0x0000,0x0000,0x0000,0x0000,0x0000,0x0000,0x0000,
	0x0000,0x0000,0x0000,0x0000,0x0000,0x0000,0x0000,0x0000,
	0x0000,0x0000,0x0000,0x0000,0x0000,0x0000,0x0000,0x0000,
	0x0000,0x0000,0x0000,0x0000,0x0000,0x0000,0x0000,0x0000,
	0x0000,0x0000,0x0000,0x0000,0x0000,0x0000,0x0000,0x0000,
	0x0000,0x0000,0x0000,0x0000,0x0000,0x0000,0x0000,0x0000,
	0x0000,0x0000,0x0000,0x0000,0x0000,0x0000,0x0000,0x0000,
	0x0000,0x0000,0x0000,0x0000,0x0000,0x0000,0x0000,0x0000,
	0x0000,0x0000,0x0000,0x0000,0x0000,0x0000,0x0000,0x0000,
	0x0000,0x0000,0x0000,0x0000,0x0000,0x0000,0x0000,0x0000,
	0x0000,0x0000,0x0000,0x0000,0x0000,0x0000,0x0000,0x0000,
	0x0000,0x0000,0x0000,0x0000,0x0000,0x0000,0x0000,0x0000,
	0x0000,0x0000,0x0000,0x0000,0x0000,0x0000,0x0000,0x0000,
	0x0000,0x0000,0x0000,0x0000,0x0000,0x0000,0x0000,0x0000,
	0x0000,0x0000,0x0000,0x0000,0x0000,0x0000,0x0000,0x0000,
	0x0000,0x0000,0x0000,0x0000,0x0000,0x0000,0x0000,0x0000,
	0x0000,0x0000,0x0000,0x0000,0x0000,0x0000,0x0000,0x0000,
	0x0000,0x0000,0x0000,0x0000,0x0000,0x0000,0x0000,0x0000,
	0x0000,0x0000,0x0000,0x0000,0x0000,0x0000,0x0000,0x0000,
	0x0000,0x0000,0x0000,0x0000,0x0000,0x0000,0x0000,0x0000,
	0x0000,0x0000,0x0000,0x0000,0x0000,0x0000,0x0000,0x0000,
	0x0000,0x0000,0x0000,0x0000,0x0000,0x0000,0x0000,0x0000,
	0x0000,0x0000,0x0000,0x0000,0x0000,0x0000,0x0000,0x0000,
	0x0000,0x0000,0x0000,0x0000,0x0000,0x0000,0x0000,0x0000,
	0x0000,0x0000,0x0000,0x0000,0x0000,0x0000,0x0000,0x0000,
	0x0000,0x0000,0x0000,0x0000,0x0000,0x0000,0x0000,0x0000,
	0x0000,0x0000,0x0000,0x0000,0x0000,0x0000,0x0000,0x0000,
	0x0000,0x0000,0x0000,0x0000,0x0000,0x0000,0x0000,0x0000,
	0x0000,0x0000,0x0000,0x0000,0x0000,0x0000,0x0000,0x0000,
	0x0000,0x0000,0x0000,0x0000,0x0000,0x0000,0x0000,0x0000,
	0x0000,0x0000,0x0000,0x0000,0x0000,0x0000,0x0000,0x0000,
	0x0000,0x0000,0x0000,0x0000,0x0000,0x0000,0x0000,0x0000,
	0x0000,0x0000,0x0000,0x0000,0x0000,0x0000,0x0000,0x0000,
	0x0000,0x0000,0x0000,0x0000,0x0000,0x0000,0x0000,0x0000,
	0x0000,0x0000,0x0000,0x0000,0x0000,0x0000,0x0000,0x0000,
	0x0000,0x0000,0x0000,0x0000,0x0000,0x0000,0x0000,0x0000,
	0x0000,0x0000,0x0000,0x0000,0x0000,0x0000,0x0000,0x0000,
	0x0000,0x0000,0x0000,0x0000,0x0000,0x0000,0x0000,0x0000,
	0x0000,0x0000,0x0000,0x0000,0x0000,0x0000,0x0000,0x0000,
	0x0000,0x0000,0x0000,0x0000,0x0000,0x0000,0x0000,0x0000,
	0x0000,0x0000,0x0000,0x0000,0x0000,0x0000,0x0000,0x0000,
	0x0000,0x0000,0x0000,0x0000,0x0000,0x0000,0x0000,0x0000,
	0x0000,0x0000,0x0000,0x0000,0x0000,0x0000,0x0000,0x0000,
	0x0000,0x0000,0x0000,0x0000,0x0000,0x0000,0x0000,0x0000,
	0x0000,0x0000,0x0000,0x0000,0x0000,0x0000,0x0000,0x0000,
	0x0000,0x0000,0x0000,0x0000,0x0000,0x0000,0x0000,0x0000,
	0x0000,0x0000,0x0000,0x0000,0x0000,0x0000,0x0000,0x0000,
	0x0000,0x0000,0x0000,0x0000,0x0000,0x0000,0x0000,0x0000,
	0x0000,0x0000,0x0000,0x0000,0x0000,0x0000,0x0000,0x0000,
	0x0000,0x0000,0x0000,0x0000,0x0000,0x0000,0x0000,0x0000,
	0x0000,0x0000,0x0000,0x0000,0x0000,0x0000,0x0000,0x0000,
	0x0000,0x0000,0x0000,0x0000,0x0000,0x0000,0x0000,0x0000,
	0x0000,0x0000,0x0000,0x0000,0x0000,0x0000,0x0000,0x0000,
	0x0000,0x0000,0x0000,0x0000,0x0000,0x0000,0x0000,0x0000,
	0x0000,0x0000,0x0000,0x0000,0x0000,0x0000,0x0000,0x0000,
	0x0000,0x0000,0x0000,0x0000,0x0000,0x0000,0x0000,0x0000,
	0x0000,0x0000,0x0000,0x0000,0x0000,0x0000,0x0000,0x0000,
	0x0000,0x0000,0x0000,0x0000,0x0000,0x0000,0x0000,0x0000,
	0x0000,0x0000,0x0000,0x0000,0x0000,0x0000,0x0000,0x0000,
	0x0000,0x0000,0x0000,0x0000,0x0000,0x0000,0x0000,0x0000,

};

